19 12
5 5 5 5 5 5 5 5 5 5 5 5 5 5 5 5 5 5 5
5 1 1 1 1 1 1 1 1 1 1 1 1 1 1 1 1 1 5 
5 1 0 8 0 0 3 3 3 3 3 3 3 3 0 0 8 0 5
5 2 0 0 0 3 3 3 3 3 3 3 3 3 3 0 0 0 5
5 2 2 2 2 2 3 3 3 3 3 3 3 3 2 2 2 2 5
5 1 0 1 0 0 0 0 4 4 4 0 0 0 0 0 1 0 5
5 1 0 1 0 8 0 0 0 4 0 0 0 0 8 0 1 0 5
5 1 4 1 0 0 0 0 0 0 0 0 0 0 0 0 1 4 5
5 1 4 1 0 0 0 1 1 7 1 1 0 0 0 0 1 4 5
5 1 4 1 0 4 4 0 9 9 9 0 4 4 0 0 1 4 5
5 1 0 1 0 4 0 0 9 6 9 0 0 4 0 0 1 0 5
5 5 5 5 5 5 5 5 5 5 5 5 5 5 5 5 5 5 5
